a	a
ai	ai
an	a n
ang	a ng
ao	ao
ba	b a
bai	b ai
ban	b a n
bang	b a ng
bao	b ao
be	b e
bei	b ei
ben	b e n
beng	b e ng
bi	b i
bian	b ia n
biao	b iao
bie	b ie
bin	b i n
bing	b i ng
bo	b o
bu	b u
ca	c a
cai	c ai
can	c a n
cang	c a ng
cao	c ao
ce	c e
cen	c e n
ceng	c e ng
cha	ch a
chai	ch ai
chan	ch a n
chang	ch a ng
chao	ch ao
che	ch e
chen	ch e n
cheng	ch e ng
chi	ch i
chong	ch o ng
chou	ch ou
chu	ch u
chua	ch ua
chuai	ch uai
chuan	ch ua n
chuang	ch ua ng
chui	ch ui
chun	ch u n
chuo	ch uo
ci	c i
cong	c o ng
cou	c ou
cu	c u
cuan	c ua n
cui	c ui
cun	c u n
cuo	c uo
da	d a
dai	d ai
dan	d a n
dang	d a ng
dao	d ao
de	d e
dei	d ei
den	d e n
deng	d e ng
di	d i
dia	d ia
dian	d ia n
diao	d iao
die	d ie
ding	d i ng
diu	d iu
dong	d o ng
dou	d ou
du	d u
duan	d ua n
dui	d ui
dun	d u n
duo	d uo
e	e
ei	ei
en	e n
ng	n
eng	e ng
er	er
fa	f a
fan	f a n
fang	f a ng
fei	f ei
fen	f e n
feng	f e ng
fo	f o
fou	f ou
fu	f u
ga	g a
gai	g ai
gan	g a n
gang	g a ng
gao	g ao
ge	g e
gei	g ei
gen	g e n
geng	g e ng
gong	g o ng
gou	g ou
gu	g u
gua	g ua
guai	g uai
guan	g ua n
guang	g ua ng
gui	g ui
gun	g u n
guo	g uo
ha	h a
hai	h ai
han	h a n
hang	h a ng
hao	h ao
he	h e
hei	h ei
hen	h e n
heng	h e ng
hong	h o ng
hou	h ou
hu	h u
hua	h ua
huai	h uai
huan	h ua n
huang	h ua ng
hui	h ui
hun	h u n
huo	h uo
ji	j i
jia	j ia
jian	j ia n
jiang	j ia ng
jiao	j iao
jie	j ie
jin	j i n
jing	j i ng
jiong	j i o ng
jiu	j iu
ju	j u
jv	j v
juan	j ua n
jue	j ue
jun	j u n
ka	k a
kai	k ai
kan	k a n
kang	k a ng
kao	k ao
ke	k e
kei	k ei
ken	k e n
keng	k e ng
kong	k o ng
kou	k ou
ku	k u
kua	k ua
kuai	k uai
kuan	k ua n
kuang	k ua ng
kui	k ui
kun	k u n
kuo	k uo
la	l a
lai	l ai
lan	l a n
lang	l a ng
lao	l ao
le	l e
lei	l ei
leng	l e ng
li	l i
lia	l ia
lian	l ia n
liang	l ia ng
liao	l iao
lie	l ie
lin	l i n
ling	l i ng
liu	l iu
lo	l o
long	l o ng
lou	l ou
lu	l u
lv	l v
luan	l ua n
lve	l v e
lue	l ue
lun	l u n
luo	l uo
ma	m a
mai	m ai
man	m a n
mang	m a ng
mao	m ao
me	m e
mei	m ei
men	m e n
meng	m e ng
mi	m i
mian	m ia n
miao	m iao
mie	m ie
min	m i n
ming	m i ng
miu	m iu
mo	m o
mou	m ou
mu	m u
na	n a
nai	n ai
nan	n a n
nang	n a ng
nao	n ao
ne	n e
nei	n ei
nen	n e n
neng	n e ng
ni	n i
nia	n ia
nian	n ia n
niang	n ia ng
niao	n iao
nie	n ie
nin	n i n
ning	n i ng
niu	n iu
nong	n o ng
nou	n ou
nu	n u
nv	n v
nuan	n ua n
nve	n v e
nue	n ue
nuo	n uo
o	o
ou	ou
pa	p a
pai	p ai
pan	p a n
pang	p a ng
pao	p ao
pe	p e
pei	p ei
pen	p e n
peng	p e ng
pi	p i
pian	p ia n
piao	p iao
pie	p ie
pin	p i n
ping	p i ng
po	p o
pou	p ou
pu	p u
qi	q i
qia	q ia
qian	q ia n
qiang	q ia ng
qiao	q iao
qie	q ie
qin	q i n
qing	q i ng
qiong	q i o ng
qiu	q iu
qu	q u
qv	q v
quan	q ua n
que	q ue
qun	q u n
ran	r a n
rang	r a ng
rao	r ao
re	r e
ren	r e n
reng	r e ng
ri	r i
rong	r o ng
rou	r ou
ru	r u
rua	r ua
ruan	r ua n
rui	r ui
run	r u n
ruo	r uo
sa	s a
sai	s ai
san	s a n
sang	s a ng
sao	s ao
se	s e
sen	s e n
seng	s e ng
sha	sh a
shai	sh ai
shan	sh a n
shang	sh a ng
shao	sh ao
she	sh e
shei	sh ei
shen	sh e n
sheng	sh e ng
shi	sh i
shou	sh ou
shu	sh u
shua	sh ua
shuai	sh uai
shuan	sh ua n
shuang	sh ua ng
shui	sh ui
shun	sh u n
shuo	sh uo
si	s i
song	s o ng
sou	s ou
su	s u
suan	s ua n
sui	s ui
sun	s u n
suo	s uo
ta	t a
tai	t ai
tan	t a n
tang	t a ng
tao	t ao
te	t e
tei	t ei
teng	t e ng
ti	t i
tian	t ia n
tiao	t iao
tie	t ie
ting	t i ng
tong	t o ng
tou	t ou
tu	t u
tuan	t ua n
tui	t ui
tun	t u n
tuo	t uo
wa	w a
wai	w ai
wan	w a n
wang	w a ng
wei	w ei
wen	w e n
weng	w e ng
wo	w o
wu	w u
xi	x i
xia	x ia
xian	x ia n
xiang	x ia ng
xiao	x iao
xie	x ie
xin	x i n
xing	x i ng
xiong	x i o ng
xiu	x iu
xu	x u
xv	x v
xuan	x ua n
xue	x ue
xun	x u n
ya	y a
yan	y a n
yang	y a ng
yao	y ao
ye	y e
yi	y i
yin	y i n
ying	y i ng
yo	y o
yong	y o ng
you	y ou
yu	y u
yv	y v
yuan	y ua n
yue	y ue
yun	y u n
za	z a
zai	z ai
zan	z a n
zang	z a ng
zao	z ao
ze	z e
zei	z ei
zen	z e n
zeng	z e ng
zha	zh a
zhai	zh ai
zhan	zh a n
zhang	zh a ng
zhao	zh ao
zhe	zh e
zhei	zh ei
zhen	zh e n
zheng	zh e ng
zhi	zh i
zhong	zh o ng
zhou	zh ou
zhu	zh u
zhua	zh ua
zhuai	zh uai
zhuan	zh ua n
zhuang	zh ua ng
zhui	zh ui
zhun	zh u n
zhuo	zh uo
zi	z i
zong	z o ng
zou	z ou
zu	z u
zuan	z ua n
zui	z ui
zun	z u n
zuo	z uo
ruai	r uai
go	g o
co	c o
ko	k o
cuang	c ua ng
zuang	z ua ng
fiao	f iao
m	m
nun	n u n
rr	er
